"filename", "language", "C++", "CMake", "comment", "blank", "total"
"c:\Users\benji\WorkSpace\Cpp\physics_simulation\src\gl_core\CMakeLists.txt", "CMake", 0, 45, 0, 3, 48
"c:\Users\benji\WorkSpace\Cpp\physics_simulation\src\gl_core\assets\CMakeLists.txt", "CMake", 0, 15, 0, 3, 18
"c:\Users\benji\WorkSpace\Cpp\physics_simulation\src\gl_core\assets\cache\CMakeLists.txt", "CMake", 0, 14, 0, 2, 16
"c:\Users\benji\WorkSpace\Cpp\physics_simulation\src\gl_core\assets\cache\cache.h", "C++", 12, 0, 0, 4, 16
"c:\Users\benji\WorkSpace\Cpp\physics_simulation\src\gl_core\assets\cache\material_cache.cpp", "C++", 10, 0, 0, 3, 13
"c:\Users\benji\WorkSpace\Cpp\physics_simulation\src\gl_core\assets\cache\material_cache.h", "C++", 14, 0, 0, 5, 19
"c:\Users\benji\WorkSpace\Cpp\physics_simulation\src\gl_core\assets\cache\mesh_cache.cpp", "C++", 10, 0, 0, 3, 13
"c:\Users\benji\WorkSpace\Cpp\physics_simulation\src\gl_core\assets\cache\mesh_cache.h", "C++", 14, 0, 0, 5, 19
"c:\Users\benji\WorkSpace\Cpp\physics_simulation\src\gl_core\assets\cache\shader_cache.cpp", "C++", 38, 0, 0, 8, 46
"c:\Users\benji\WorkSpace\Cpp\physics_simulation\src\gl_core\assets\cache\shader_cache.h", "C++", 16, 0, 0, 4, 20
"c:\Users\benji\WorkSpace\Cpp\physics_simulation\src\gl_core\assets\material.cpp", "C++", 0, 0, 0, 1, 1
"c:\Users\benji\WorkSpace\Cpp\physics_simulation\src\gl_core\assets\material.h", "C++", 19, 0, 1, 9, 29
"c:\Users\benji\WorkSpace\Cpp\physics_simulation\src\gl_core\assets\mesh.cpp", "C++", 171, 0, 15, 31, 217
"c:\Users\benji\WorkSpace\Cpp\physics_simulation\src\gl_core\assets\mesh.h", "C++", 107, 0, 15, 35, 157
"c:\Users\benji\WorkSpace\Cpp\physics_simulation\src\gl_core\assets\shader.cpp", "C++", 225, 0, 5, 24, 254
"c:\Users\benji\WorkSpace\Cpp\physics_simulation\src\gl_core\assets\shader.h", "C++", 62, 0, 6, 9, 77
"c:\Users\benji\WorkSpace\Cpp\physics_simulation\src\gl_core\batch_renderer.cpp", "C++", 118, 0, 1, 32, 151
"c:\Users\benji\WorkSpace\Cpp\physics_simulation\src\gl_core\batch_renderer.h", "C++", 52, 0, 0, 23, 75
"c:\Users\benji\WorkSpace\Cpp\physics_simulation\src\gl_core\camera.cpp", "C++", 84, 0, 0, 9, 93
"c:\Users\benji\WorkSpace\Cpp\physics_simulation\src\gl_core\camera.h", "C++", 41, 0, 0, 15, 56
"c:\Users\benji\WorkSpace\Cpp\physics_simulation\src\gl_core\core\CMakeLists.txt", "CMake", 0, 13, 0, 2, 15
"c:\Users\benji\WorkSpace\Cpp\physics_simulation\src\gl_core\core\context.cpp", "C++", 167, 0, 37, 30, 234
"c:\Users\benji\WorkSpace\Cpp\physics_simulation\src\gl_core\core\context.h", "C++", 90, 0, 2, 14, 106
"c:\Users\benji\WorkSpace\Cpp\physics_simulation\src\gl_core\core\engine.cpp", "C++", 13, 0, 0, 3, 16
"c:\Users\benji\WorkSpace\Cpp\physics_simulation\src\gl_core\core\engine.h", "C++", 23, 0, 3, 11, 37
"c:\Users\benji\WorkSpace\Cpp\physics_simulation\src\gl_core\core\services.cpp", "C++", 5, 0, 0, 1, 6
"c:\Users\benji\WorkSpace\Cpp\physics_simulation\src\gl_core\core\services.h", "C++", 24, 0, 0, 8, 32
"c:\Users\benji\WorkSpace\Cpp\physics_simulation\src\gl_core\core\vertex.h", "C++", 23, 0, 4, 6, 33
"c:\Users\benji\WorkSpace\Cpp\physics_simulation\src\gl_core\gui.cpp", "C++", 258, 0, 55, 25, 338
"c:\Users\benji\WorkSpace\Cpp\physics_simulation\src\gl_core\gui.h", "C++", 55, 0, 2, 15, 72
"c:\Users\benji\WorkSpace\Cpp\physics_simulation\src\gl_core\physics_object.cpp", "C++", 1, 0, 0, 0, 1
"c:\Users\benji\WorkSpace\Cpp\physics_simulation\src\gl_core\physics_object.h", "C++", 17, 0, 0, 8, 25
"c:\Users\benji\WorkSpace\Cpp\physics_simulation\src\gl_core\pipeline.cpp", "C++", 22, 0, 5, 7, 34
"c:\Users\benji\WorkSpace\Cpp\physics_simulation\src\gl_core\pipeline.h", "C++", 69, 0, 11, 22, 102
"c:\Users\benji\WorkSpace\Cpp\physics_simulation\src\gl_core\rigidbody.cpp", "C++", 30, 0, 2, 8, 40
"c:\Users\benji\WorkSpace\Cpp\physics_simulation\src\gl_core\rigidbody.h", "C++", 41, 0, 0, 10, 51
"c:\Users\benji\WorkSpace\Cpp\physics_simulation\src\gl_core\scene.cpp", "C++", 13, 0, 0, 6, 19
"c:\Users\benji\WorkSpace\Cpp\physics_simulation\src\gl_core\scene.h", "C++", 22, 0, 0, 6, 28
"c:\Users\benji\WorkSpace\Cpp\physics_simulation\src\gl_core\servers\CMakeLists.txt", "CMake", 0, 8, 0, 2, 10
"c:\Users\benji\WorkSpace\Cpp\physics_simulation\src\gl_core\servers\renderer.cpp", "C++", 158, 0, 2, 26, 186
"c:\Users\benji\WorkSpace\Cpp\physics_simulation\src\gl_core\servers\renderer.h", "C++", 64, 0, 1, 17, 82
"c:\Users\benji\WorkSpace\Cpp\physics_simulation\src\gl_core\tensor.cpp", "C++", 9, 0, 4, 4, 17
"c:\Users\benji\WorkSpace\Cpp\physics_simulation\src\gl_core\tensor.h", "C++", 99, 0, 39, 28, 166
"c:\Users\benji\WorkSpace\Cpp\physics_simulation\src\gl_core\texture_man.cpp", "C++", 71, 0, 0, 16, 87
"c:\Users\benji\WorkSpace\Cpp\physics_simulation\src\gl_core\texture_man.h", "C++", 35, 0, 1, 10, 46
"Total", "-", 2302, 95, 211, 513, 3121